112222211
122333221
223343322
233444332
234444432
233444332
223343322
122333221
112222211
