44444444443333221111
44444444443332221111
44444443333333222222
33333222222233333333
33222221112222333333
22222221111133333333
11222211122233333344
11111122222344444444
11222222333344444444
22222333333444455555
22333334444555555555
33333444455555555555
33444444455555555555
44444445555555555555
55555555555555555555
55555555555555555555
44455555555555555555
33344555555555555555
12233345555555555555
11123334445555555555
