1111111111111111111
2222222222222222222
3333333333333333333
4444444444444444444
5555555555555555555
4444444444444444444
3333333333333333333
2222222222222222222
1111111111111111111
1111111111111111111
2222222222222222222
3333333333333333333
4444444444444444444
5555555555555555555
4444444444444444444
3333333333333333333
2222222222222222222
1111111111111111111
2222222222222222222
3333333333333333333
